選手姓名 - 隊名	組	勝	敗	場	勝率	入選賽次	決選數	勝局	敗局	總局	局勝率
蘇昱綸 - 合作金庫	男	6	0	6	1.000	第一次賽	1	18	4	22	0.818
洪敬愷 - 第一銀行	男	6	0	6	1.000	第一次賽	1	18	7	25	0.720
黎彥君 - 第一銀行	男	9	1	10	0.900	第二次賽	1	28	10	38	0.737
張佑安 - 第一銀行	男	6	1	7	0.857	第二次賽	1	20	8	28	0.714
馮翊新 - 合作金庫	男	17	3	20	0.850	第四次賽	3	54	18	72	0.750
林彥均 - 第一銀行	男	11	2	13	0.846	第三次賽	1	37	13	50	0.740
黃彥誠 - 合作金庫	男	9	2	11	0.818	第三次賽	1	30	14	44	0.682
廖振珽 - 第一銀行	男	16	4	20	0.800	第五次賽	2	53	17	70	0.757
彭王維 - 乒乓彭	男	15	4	19	0.789	第五次賽	2	49	25	74	0.662
陳建安 - 合作金庫	男	11	3	14	0.786	-	0	37	12	49	0.755
徐絃家 - 合作金庫	男	16	5	21	0.762	第六次賽	2	53	27	80	0.662
黎昕陽 - 第一銀行	男	9	3	12	0.750	第四次賽	1	32	12	44	0.727
曾子彧 - 合作金庫	男	16	6	22	0.727	-	0	56	28	84	0.667
孫嘉宏 - 合作金庫	男	13	5	18	0.722	-	1	43	29	72	0.597
葉致緯 - 第一銀行	男	15	6	21	0.714	-	0	52	22	74	0.703
陳凱程 - 合作金庫	男	15	6	21	0.714	-	1	50	35	85	0.588
王冠程 - 八馬國際	男	12	5	17	0.706	第六次賽	1	44	30	74	0.595
楊子儀 - 合作金庫	男	14	6	20	0.700	-	0	50	27	77	0.649
黎昕祐 - 第一銀行	男	14	6	20	0.700	-	0	51	30	81	0.630
張秉丞 - 第一銀行	男	14	6	20	0.700	-	2	47	31	78	0.603
楊嘉安 - 第一銀行	男	14	6	20	0.700	-	0	48	32	80	0.600
王泰崴 - 合作金庫	男	13	6	19	0.684	-	1	46	26	72	0.639
楊皓任 - 第一銀行	男	12	6	18	0.667	-	0	42	26	68	0.618
施佳宏 - 第一銀行	男	11	6	17	0.647	-	0	38	26	64	0.594
曾暐勛 - 臺南桌委	男	11	6	17	0.647	-	1	36	29	65	0.554
楊振岳 - 合作金庫	男	11	6	17	0.647	-	0	35	30	65	0.538
李佳陞 - 第一銀行	男	11	6	17	0.647	-	0	37	32	69	0.536
楊恆韋 - 第一銀行	男	10	6	16	0.625	-	0	36	23	59	0.610
何恩 - 松山家商	男	10	6	16	0.625	-	0	37	27	64	0.578
蘇晨翔 - 合作金庫	男	10	6	16	0.625	-	0	35	27	62	0.565
蔡榜原 - 合作金庫	男	8	5	13	0.615	-	0	27	25	52	0.519
吳元佑 - 合作金庫	男	9	6	15	0.600	-	0	34	19	53	0.642
蔡天羽 - 合作金庫	男	9	6	15	0.600	-	0	30	26	56	0.536
戴博鈞 - 合作金庫	男	9	6	15	0.600	-	0	32	28	60	0.533
黃培祐 - 合作金庫	男	9	6	15	0.600	-	0	32	28	60	0.533
王晨又 - 第一銀行	男	9	6	15	0.600	-	0	29	26	55	0.527
郭家宏 - 臺灣師大	男	7	5	12	0.583	-	0	24	23	47	0.511
梁振威 - 合作金庫	男	8	6	14	0.571	-	0	29	22	51	0.569
蔡賾安 - 第一銀行	男	8	6	14	0.571	-	0	28	23	51	0.549
彭靖宥 - 合作金庫	男	8	6	14	0.571	-	0	30	26	56	0.536
梅日燁 - 臺灣師大	男	8	6	14	0.571	-	0	28	26	54	0.519
蕭子睿 - 合作金庫	男	8	6	14	0.571	-	0	31	29	60	0.517
譚吉倉 - 臺南桌委	男	5	4	9	0.556	-	0	17	18	35	0.486
蔡淳佑 - 臺南桌委	男	6	5	11	0.545	-	0	21	20	41	0.512
洪哲硯 - 合作金庫	男	7	6	13	0.538	-	0	29	22	51	0.569
莊家權 - 合作金庫	男	7	6	13	0.538	-	1	29	23	52	0.558
林鄭文哲 - 合作金庫	男	7	6	13	0.538	-	0	26	21	47	0.553
林晉霆 - 第一銀行	男	7	6	13	0.538	-	0	28	26	54	0.519
余奕慶 - 合作金庫	男	7	6	13	0.538	-	0	27	29	56	0.482
彭 旨 - 北市大	男	7	6	13	0.538	-	0	21	27	48	0.438
葉伊恩 - 智淵乒乓	男	6	6	12	0.500	-	0	24	20	44	0.545
趙柏宥 - 合作金庫	男	6	6	12	0.500	-	0	24	22	46	0.522
戴茗葦 - 北市大	男	6	6	12	0.500	-	0	24	22	46	0.522
程弘宇 - 松山家商	男	6	6	12	0.500	-	0	24	22	46	0.522
黃浩瑋 - 臺灣體大	男	6	6	12	0.500	-	0	22	21	43	0.512
劉士銘 - 第一銀行	男	6	6	12	0.500	-	0	23	23	46	0.500
黃弘州 - 屏東科大	男	6	6	12	0.500	-	0	23	28	51	0.451
陳奕騰 - 第一銀行	男	5	6	11	0.455	-	0	24	20	44	0.545
莊忠諺 - 合作金庫	男	5	6	11	0.455	-	0	21	21	42	0.500
李承恩 - 臺灣體大	男	5	6	11	0.455	-	0	21	21	42	0.500
鄭旻修 - 合作金庫	男	5	6	11	0.455	-	0	24	24	48	0.500
陳宜樂 - 第一銀行	男	5	6	11	0.455	-	0	21	22	43	0.488
林一帆 - 智淵乒乓	男	5	6	11	0.455	-	0	18	23	41	0.439
闕壯庭 - 北市大	男	5	6	11	0.455	-	0	17	23	40	0.425
高偉誌 - 智淵乒乓	男	4	6	10	0.400	-	0	18	18	36	0.500
陳俊侑 - 東泰高中	男	4	6	10	0.400	-	0	15	18	33	0.455
陳俊廷 - 個人報名	男	4	6	10	0.400	-	0	18	22	40	0.450
賴竑亦 - 八馬國際	男	4	6	10	0.400	-	0	18	22	40	0.450
梁庭瑋 - 國立體大	男	4	6	10	0.400	-	0	16	21	37	0.432
楊致興 - 北市大	男	4	6	10	0.400	-	0	14	19	33	0.424
董少丞 - 臺灣師大	男	4	6	10	0.400	-	0	16	22	38	0.421
彭靖恩 - 臺南桌委	男	4	6	10	0.400	-	0	16	22	38	0.421
周秉澄 - 松山家商	男	3	5	8	0.375	-	0	14	17	31	0.452
張家皓 - 國立體大	男	3	6	9	0.333	-	0	17	18	35	0.486
黃毓仁 - 第一銀行	男	2	4	6	0.333	-	0	11	13	24	0.458
林子恩 - 臺灣體大	男	3	6	9	0.333	-	0	15	18	33	0.455
張先騅 - 福誠高中	男	3	6	9	0.333	-	0	16	20	36	0.444
張睿煬 - 第一銀行	男	3	6	9	0.333	-	0	15	20	35	0.429
邱笠宸 - 合作金庫	男	3	6	9	0.333	-	0	15	20	35	0.429
楊謝翊 - 智淵乒乓	男	3	6	9	0.333	-	0	15	22	37	0.405
辜崇晏 - 臺灣體大	男	3	6	9	0.333	-	0	14	21	35	0.400
林孟帆 - 中華國中	男	3	6	9	0.333	-	0	13	20	33	0.394
李俊霆 - 第一銀行	男	3	6	9	0.333	-	0	13	21	34	0.382
黃守心 - 松山家商	男	3	6	9	0.333	-	0	14	24	38	0.368
周奕安 - 海山高中	男	3	6	9	0.333	-	0	12	24	36	0.333
余秉宸 - 合作金庫	男	2	6	8	0.250	-	0	15	18	33	0.455
柯勇全 - 智淵乒乓	男	2	6	8	0.250	-	0	12	20	32	0.375
林大棋 - 福誠高中	男	2	6	8	0.250	-	0	11	20	31	0.355
吳秋信 - 臺灣體大	男	2	6	8	0.250	-	0	10	19	29	0.345
張力元 - 八馬國際	男	2	6	8	0.250	-	0	10	19	29	0.345
方詠恩 - 第一銀行	男	2	6	8	0.250	-	0	10	20	30	0.333
曾宥維 - 八馬國際	男	2	6	8	0.250	-	0	9	19	28	0.321
姜承佑 - 海山高中	男	2	6	8	0.250	-	0	9	19	28	0.321
何少汯 - 香山高中	男	2	6	8	0.250	-	0	9	22	31	0.290
邱祐宏 - 臺灣師大	男	1	4	5	0.200	-	0	5	12	17	0.294
張岳 - 彰德國中	男	1	4	5	0.200	-	0	5	13	18	0.278
謝譯賢 - 個人報名	男	1	5	6	0.167	-	0	5	17	22	0.227
葉易樺 - 八馬國際	男	1	5	6	0.167	-	0	4	16	20	0.200
呂亮緯 - 金石乒乓	男	1	6	7	0.143	-	0	13	19	32	0.406
吳喆安 - 高雄師範	男	1	6	7	0.143	-	0	12	18	30	0.400
方炳崴 - 第一銀行	男	1	6	7	0.143	-	0	11	18	29	0.379
陳柏諺 - 海山高中	男	1	6	7	0.143	-	0	11	18	29	0.379
謝承翰 - 東山高中	男	1	6	7	0.143	-	0	8	19	27	0.296
彭聖棋 - 香山高中	男	1	6	7	0.143	-	0	7	18	25	0.280
蕭惟之 - 八馬國際	男	1	6	7	0.143	-	0	7	19	26	0.269
黃祐柏 - 合作金庫	男	1	6	7	0.143	-	0	7	19	26	0.269
林學庸 - 臺南桌委	男	1	6	7	0.143	-	0	7	20	27	0.259
林子鈞 - 個人報名	男	1	6	7	0.143	-	0	7	20	27	0.259
陳浩洋 - 東山高中	男	1	6	7	0.143	-	0	5	19	24	0.208
洪翔宥 - 海山高中	男	1	6	7	0.143	-	0	5	19	24	0.208
陳又安 - 至正國中	男	1	6	7	0.143	-	0	3	18	21	0.143
廖堉棋 - 合作金庫	男	0	3	3	0.000	-	0	4	9	13	0.308
張秉恩 - 第一銀行	男	0	6	6	0.000	-	0	7	18	25	0.280
許宸逢 - 八馬國際	男	0	6	6	0.000	-	0	5	18	23	0.217
張致榮 - 藝術高中	男	0	6	6	0.000	-	0	3	18	21	0.143
李宇 - 東山高中	男	0	6	6	0.000	-	0	3	18	21	0.143
黃紹愷 - 中信國小	男	0	4	4	0.000	-	0	2	12	14	0.143
許詠傑 - 藝術高中	男	0	5	5	0.000	-	0	2	15	17	0.118
蔡宗桓 - 金石乒乓	男	0	6	6	0.000	-	0	1	18	19	0.053
陳楷庭 - 屏東科大	男	0	6	6	0.000	-	0	1	18	19	0.053
虞善琦 - 	男	0	6	6	0.000	-	0	0	18	18	0.000
陳柏鈞 - 金石乒乓	男	0	6	6	0.000	-	0	0	18	18	0.000
林思佑 - 東山高中	男	0	6	6	0.000	-	0	0	18	18	0.000
李冠炫 - 香山高中	男	0	6	6	0.000	-	0	0	18	18	0.000
朱芫毅 - 至正國中	男	0	6	6	0.000	-	0	0	18	18	0.000
楊博翔 - 臺灣師大	男	0	2	2	0.000	-	0	0	6	6	0.000
顏瑜廷 - 個人報名	男	0	6	6	0.000	-	0	0	18	18	0.000
