選手姓名 - 隊名	組	勝	敗	場	勝率	入選賽次	決選數	勝局	敗局	總局	局勝率
葉伊恬 - 合作金庫	女	6	0	6	1.000	第一次賽	1	18	3	21	0.857
吳映萱 - 國泰人壽	女	6	0	6	1.000	第一次賽	1	18	5	23	0.783
李昱諄 - 國泰人壽	女	7	1	8	0.875	第二次賽	1	23	7	30	0.767
彭郁涵 - 國泰人壽	女	6	1	7	0.857	第二次賽	1	19	9	28	0.679
黃禹喬 - 國泰人壽	女	10	2	12	0.833	第三次賽	2	33	13	46	0.717
陳忞昕 - 合作金庫	女	8	2	10	0.800	第三次賽	1	26	10	36	0.722
高凡媞 - 國泰人壽	女	12	3	15	0.800	第四次賽	2	38	25	63	0.603
黃 歆 - 國泰人壽	女	11	3	14	0.786	第四次賽	1	38	16	54	0.704
鄭樸璿 - 合作金庫	女	18	5	23	0.783	第六次賽	3	58	28	86	0.674
陳琦媗 - 合作金庫	女	14	4	18	0.778	第五次賽	1	49	20	69	0.710
蔡昀恩 - 合作金庫	女	14	4	18	0.778	第五次賽	1	47	21	68	0.691
王意如 - 合作金庫	女	16	6	22	0.727	-	2	56	28	84	0.667
鄭先知 - 國泰人壽	女	15	6	21	0.714	-	2	52	29	81	0.642
劉馨尹 - 國泰人壽	女	15	6	21	0.714	-	1	52	31	83	0.627
王媺淇 - 國泰人壽	女	15	6	21	0.714	-	1	50	31	81	0.617
簡彤娟 - 國泰人壽	女	14	6	20	0.700	-	0	50	29	79	0.633
李婉瑄 - 北市大	女	14	6	20	0.700	-	0	47	32	79	0.595
吳宜琪 - 北市大	女	13	6	19	0.684	-	0	42	29	71	0.592
陳思羽 - 國泰人壽	女	4	2	6	0.667	-	1	14	9	23	0.609
蘇珮綾 - 合作金庫	女	12	6	18	0.667	-	0	42	28	70	0.600
巫嘉恩 - 國泰人壽	女	10	5	15	0.667	第六次賽	1	35	24	59	0.593
陳映蓁 - 國泰人壽	女	11	6	17	0.647	-	0	42	24	66	0.636
林珈芝 - 合作金庫	女	11	6	17	0.647	-	0	33	22	55	0.600
陳慈瑄 - 高雄中學	女	11	6	17	0.647	-	0	36	30	66	0.545
郭語瑄 - 合作金庫	女	10	6	16	0.625	-	0	38	26	64	0.594
王小昕 - 合作金庫	女	10	6	16	0.625	-	0	36	25	61	0.590
陳佳宜 - 國泰人壽	女	10	6	16	0.625	-	1	35	26	61	0.574
朱以晴 - 國泰人壽	女	10	6	16	0.625	-	0	34	27	61	0.557
林佳慧 - 國泰人壽	女	8	5	13	0.615	-	0	32	22	54	0.593
黃淨嘉 - 合作金庫	女	9	6	15	0.600	-	0	32	26	58	0.552
張孟媫 - 臺灣體大	女	7	5	12	0.583	-	0	26	19	45	0.578
貢慕慈 - 合作金庫	女	8	6	14	0.571	-	0	30	23	53	0.566
陳祈韻 - 合作金庫	女	7	6	13	0.538	-	0	31	25	56	0.554
廖庭瑤 - 國泰人壽	女	7	6	13	0.538	-	0	27	22	49	0.551
黃君凡 - 合作金庫	女	7	6	13	0.538	-	0	27	26	53	0.509
張浿珊 - 國泰人壽	女	7	6	13	0.538	-	0	24	25	49	0.490
林芊瑩 - 國泰人壽	女	6	6	12	0.500	-	0	25	20	45	0.556
陳亭婷 - 臺灣師大	女	6	6	12	0.500	-	0	24	20	44	0.545
劉如紜 - 合作金庫	女	6	6	12	0.500	-	0	24	21	45	0.533
梁羽芯 - 合作金庫	女	6	6	12	0.500	-	0	22	22	44	0.500
李唯寧 - 合作金庫	女	6	6	12	0.500	-	0	25	25	50	0.500
裴紫妮 - 臺灣師大	女	6	6	12	0.500	-	0	25	27	52	0.481
蔡佩蓉 - 合作金庫	女	6	6	12	0.500	-	0	21	24	45	0.467
鄭嘉倩 - 國泰人壽	女	5	6	11	0.455	-	0	18	25	43	0.419
陳皓萱 - 內湖高工	女	5	6	11	0.455	-	0	19	27	46	0.413
蔡豐恩 - 國泰人壽	女	4	6	10	0.400	-	0	16	19	35	0.457
魏安屏 - 國泰人壽	女	4	6	10	0.400	-	0	20	24	44	0.455
葉珈妤 - 合作金庫	女	4	6	10	0.400	-	0	17	23	40	0.425
呂函叡 - 合作金庫	女	4	6	10	0.400	-	0	18	25	43	0.419
葉馨榆 - 國泰人壽	女	4	6	10	0.400	-	0	15	22	37	0.405
林琬容 - 國泰人壽	女	3	6	9	0.333	-	0	18	21	39	0.462
李霈蓉 - 國泰人壽	女	3	6	9	0.333	-	0	16	20	36	0.444
洪苡茿 - 合作金庫	女	3	6	9	0.333	-	0	15	19	34	0.441
陳沁伶 - 八馬國際	女	3	6	9	0.333	-	0	14	20	34	0.412
黃文婷 - 臺灣體大	女	3	6	9	0.333	-	0	13	21	34	0.382
林姿妍 - 臺南桌委	女	3	6	9	0.333	-	0	13	23	36	0.361
賴郁蓁 - 合作金庫	女	3	6	9	0.333	-	0	11	20	31	0.355
梁羽宸 - 北市大	女	3	6	9	0.333	-	0	12	22	34	0.353
梁菀庭 - 國立體大	女	3	6	9	0.333	-	0	11	21	32	0.344
謝于璇 - 臺灣師大	女	3	6	9	0.333	-	0	12	24	36	0.333
林芯妤 - 國泰人壽	女	3	6	9	0.333	-	0	14	40	54	0.259
林翌蓁 - 高雄中學	女	2	6	8	0.250	-	0	13	19	32	0.406
林奐諪 - 合作金庫	女	2	6	8	0.250	-	0	13	21	34	0.382
黃薇安 - 合作金庫	女	2	6	8	0.250	-	0	12	20	32	0.375
賴萱恩 - 國泰人壽	女	2	6	8	0.250	-	0	12	20	32	0.375
呂瑀恩 - 合作金庫	女	2	6	8	0.250	-	0	10	19	29	0.345
簡宏卿 - 內湖高工	女	2	6	8	0.250	-	0	11	22	33	0.333
楊芸婕 - 國泰人壽	女	2	6	8	0.250	-	0	10	21	31	0.323
蔡佳靜 - 合作金庫	女	2	6	8	0.250	-	0	10	21	31	0.323
呂姍穎 - 八馬國際	女	2	6	8	0.250	-	0	10	21	31	0.323
廖頤暄 - 國泰人壽	女	2	6	8	0.250	-	0	9	20	29	0.310
黃韞纈 - 合作金庫	女	2	6	8	0.250	-	0	8	19	27	0.296
鄭晴文 - 國泰人壽	女	2	6	8	0.250	-	0	8	20	28	0.286
陳瑞翎 - 國泰人壽	女	2	6	8	0.250	-	0	8	21	29	0.276
王毓潔 - 國泰人壽	女	2	7	9	0.222	-	0	36	21	57	0.632
黃敏瑜 - 北市大	女	1	5	6	0.167	-	0	11	16	27	0.407
于修婷 - 國立體大	女	1	5	6	0.167	-	0	7	16	23	0.304
洪可珊 - 北市大	女	1	5	6	0.167	-	0	4	15	19	0.211
林芯彤 - 國泰人壽	女	1	6	7	0.143	-	0	12	20	32	0.375
許淳瑄 - 國泰人壽	女	1	6	7	0.143	-	0	10	18	28	0.357
謝昕融 - 合作金庫	女	1	6	7	0.143	-	0	9	18	27	0.333
陳芋臻 - 合作金庫	女	1	6	7	0.143	-	0	8	19	27	0.296
劉羽英 - 八馬國際	女	1	6	7	0.143	-	0	8	20	28	0.286
姜沛昀 - 福誠高中	女	1	6	7	0.143	-	0	7	18	25	0.280
吳妤彤 - 智淵乒乓	女	1	6	7	0.143	-	0	6	18	24	0.250
李任悅 - 國泰人壽	女	1	6	7	0.143	-	0	5	18	23	0.217
張滋育 - 海山高中	女	1	6	7	0.143	-	0	4	20	24	0.167
劉聿兒 - 清華大學	女	0	5	5	0.000	-	0	5	15	20	0.250
蔡侑臻 - 合作金庫	女	0	6	6	0.000	-	0	6	18	24	0.250
鄭婕伶 - 國立體大	女	0	6	6	0.000	-	0	4	18	22	0.182
詹筱筑 - 中港高中	女	0	6	6	0.000	-	0	4	18	22	0.182
黃湘玲 - 海山高中	女	0	6	6	0.000	-	0	4	18	22	0.182
許依宸 - 北市大	女	0	5	5	0.000	-	0	2	15	17	0.118
簡詩耘 - 個人報名	女	0	3	3	0.000	-	0	1	9	10	0.100
蔡可萱 - 中港高中	女	0	6	6	0.000	-	0	0	18	18	0.000
姚力榳 - Dreams乒乓	女	0	5	5	0.000	-	0	0	15	15	0.000
