選手姓名 - 隊名	組	勝	敗	場	勝率	入選賽次	決選數	勝局	敗局	總局	局勝率
葉伊恬 - 合作金庫	女	6	0	6	1.000	第一次賽	1	18	3	21	0.857
吳映萱 - 國泰人壽	女	6	0	6	1.000	第一次賽	1	18	5	23	0.783
李昱諄 - 國泰人壽	女	7	1	8	0.875	第二次賽	1	23	7	30	0.767
彭郁涵 - 國泰人壽	女	6	1	7	0.857	第二次賽	1	19	9	28	0.679
黃禹喬 - 國泰人壽	女	10	2	12	0.833	第三次賽	2	33	13	46	0.717
陳忞昕 - 合作金庫	女	8	2	10	0.800	第三次賽	1	26	10	36	0.722
高凡媞 - 國泰人壽	女	12	3	15	0.800	第四次賽	2	38	25	63	0.603
黃 歆 - 國泰人壽	女	11	3	14	0.786	第四次賽	1	38	16	54	0.704
蘇珮綾 - 合作金庫	女	12	4	16	0.750	-	0	39	22	61	0.639
蔡昀恩 - 合作金庫	女	11	4	15	0.733	-	0	38	16	54	0.704
陳琦媗 - 合作金庫	女	11	4	15	0.733	-	0	40	18	58	0.690
鄭樸璿 - 合作金庫	女	11	4	15	0.733	-	1	36	17	53	0.679
簡彤娟 - 國泰人壽	女	11	4	15	0.733	-	0	39	21	60	0.650
劉馨尹 - 國泰人壽	女	11	4	15	0.733	-	1	38	23	61	0.623
鄭先知 - 國泰人壽	女	13	5	18	0.722	-	2	46	24	70	0.657
王意如 - 合作金庫	女	10	4	14	0.714	-	1	35	21	56	0.625
王媺淇 - 國泰人壽	女	10	4	14	0.714	-	0	32	20	52	0.615
吳宜琪 - 北市大	女	10	4	14	0.714	-	0	32	21	53	0.604
陳映蓁 - 國泰人壽	女	9	4	13	0.692	-	0	32	18	50	0.640
陳慈瑄 - 高雄中學	女	9	4	13	0.692	-	0	29	22	51	0.569
李婉瑄 - 北市大	女	9	4	13	0.692	-	0	29	23	52	0.558
張孟媫 - 臺灣體大	女	6	3	9	0.667	-	0	21	11	32	0.656
陳思羽 - 國泰人壽	女	4	2	6	0.667	-	1	14	9	23	0.609
王小昕 - 合作金庫	女	9	5	14	0.643	-	0	32	22	54	0.593
林珈芝 - 合作金庫	女	7	4	11	0.636	-	0	21	13	34	0.618
郭語瑄 - 合作金庫	女	7	4	11	0.636	-	0	26	18	44	0.591
朱以晴 - 國泰人壽	女	7	4	11	0.636	-	0	25	18	43	0.581
貢慕慈 - 合作金庫	女	8	5	13	0.615	-	0	30	20	50	0.600
黃淨嘉 - 合作金庫	女	7	5	12	0.583	-	0	24	21	45	0.533
林佳慧 - 國泰人壽	女	5	4	9	0.556	-	0	22	15	37	0.595
陳佳宜 - 國泰人壽	女	5	4	9	0.556	-	0	18	18	36	0.500
林芊瑩 - 國泰人壽	女	6	5	11	0.545	-	0	24	17	41	0.585
陳亭婷 - 臺灣師大	女	6	5	11	0.545	-	0	22	17	39	0.564
劉如紜 - 合作金庫	女	6	5	11	0.545	-	0	22	18	40	0.550
黃君凡 - 合作金庫	女	6	5	11	0.545	-	0	23	21	44	0.523
李唯寧 - 合作金庫	女	6	5	11	0.545	-	0	23	22	45	0.511
蔡佩蓉 - 合作金庫	女	6	5	11	0.545	-	0	21	21	42	0.500
張浿珊 - 國泰人壽	女	6	5	11	0.545	-	0	21	22	43	0.488
蔡豐恩 - 國泰人壽	女	4	4	8	0.500	-	0	16	13	29	0.552
廖庭瑤 - 國泰人壽	女	5	5	10	0.500	-	0	20	17	37	0.541
梁羽芯 - 合作金庫	女	5	5	10	0.500	-	0	19	17	36	0.528
巫嘉恩 - 國泰人壽	女	5	5	10	0.500	-	0	20	18	38	0.526
裴紫妮 - 臺灣師大	女	5	5	10	0.500	-	0	21	22	43	0.488
鄭嘉倩 - 國泰人壽	女	5	5	10	0.500	-	0	18	22	40	0.450
陳祈韻 - 合作金庫	女	4	5	9	0.444	-	0	20	20	40	0.500
魏安屏 - 國泰人壽	女	4	5	9	0.444	-	0	18	21	39	0.462
葉珈妤 - 合作金庫	女	4	5	9	0.444	-	0	17	20	37	0.459
陳皓萱 - 內湖高工	女	4	5	9	0.444	-	0	16	22	38	0.421
黃文婷 - 臺灣體大	女	3	4	7	0.429	-	0	12	15	27	0.444
謝于璇 - 臺灣師大	女	3	4	7	0.429	-	0	10	18	28	0.357
林琬容 - 國泰人壽	女	3	5	8	0.375	-	0	16	18	34	0.471
李霈蓉 - 國泰人壽	女	3	5	8	0.375	-	0	15	17	32	0.469
洪苡茿 - 合作金庫	女	3	5	8	0.375	-	0	14	16	30	0.467
林芯妤 - 國泰人壽	女	3	5	8	0.375	-	0	12	17	29	0.414
梁羽宸 - 北市大	女	3	5	8	0.375	-	0	12	19	31	0.387
林姿妍 - 臺南桌委	女	2	4	6	0.333	-	0	8	16	24	0.333
林翌蓁 - 高雄中學	女	2	5	7	0.286	-	0	12	16	28	0.429
呂函叡 - 合作金庫	女	2	5	7	0.286	-	0	12	18	30	0.400
陳沁伶 - 八馬國際	女	2	5	7	0.286	-	0	10	15	25	0.400
呂瑀恩 - 合作金庫	女	2	5	7	0.286	-	0	10	16	26	0.385
林奐諪 - 合作金庫	女	2	5	7	0.286	-	0	11	18	29	0.379
賴萱恩 - 國泰人壽	女	2	5	7	0.286	-	0	10	17	27	0.370
簡宏卿 - 內湖高工	女	2	5	7	0.286	-	0	11	19	30	0.367
楊芸婕 - 國泰人壽	女	2	5	7	0.286	-	0	10	18	28	0.357
蔡佳靜 - 合作金庫	女	2	5	7	0.286	-	0	10	18	28	0.357
賴郁蓁 - 合作金庫	女	2	5	7	0.286	-	0	8	17	25	0.320
鄭晴文 - 國泰人壽	女	2	5	7	0.286	-	0	8	17	25	0.320
陳瑞翎 - 國泰人壽	女	2	5	7	0.286	-	0	8	18	26	0.308
呂姍穎 - 八馬國際	女	2	5	7	0.286	-	0	8	18	26	0.308
葉馨榆 - 國泰人壽	女	2	5	7	0.286	-	0	8	18	26	0.308
梁菀庭 - 國立體大	女	2	5	7	0.286	-	0	8	18	26	0.308
廖頤暄 - 國泰人壽	女	2	5	7	0.286	-	0	7	17	24	0.292
黃韞纈 - 合作金庫	女	2	5	7	0.286	-	0	6	16	22	0.273
王毓潔 - 國泰人壽	女	1	4	5	0.200	-	0	7	12	19	0.368
黃敏瑜 - 北市大	女	1	5	6	0.167	-	0	11	16	27	0.407
陳芋臻 - 合作金庫	女	1	5	6	0.167	-	0	8	16	24	0.333
黃薇安 - 合作金庫	女	1	5	6	0.167	-	0	8	17	25	0.320
姜沛昀 - 福誠高中	女	1	5	6	0.167	-	0	7	15	22	0.318
劉羽英 - 八馬國際	女	1	5	6	0.167	-	0	7	17	24	0.292
吳妤彤 - 智淵乒乓	女	1	5	6	0.167	-	0	6	15	21	0.286
李任悅 - 國泰人壽	女	1	5	6	0.167	-	0	5	15	20	0.250
洪可珊 - 北市大	女	1	5	6	0.167	-	0	4	15	19	0.211
張滋育 - 海山高中	女	1	5	6	0.167	-	0	3	17	20	0.150
林芯彤 - 國泰人壽	女	0	5	5	0.000	-	0	9	15	24	0.375
謝昕融 - 合作金庫	女	0	5	5	0.000	-	0	6	15	21	0.286
許淳瑄 - 國泰人壽	女	0	5	5	0.000	-	0	6	15	21	0.286
蔡侑臻 - 合作金庫	女	0	5	5	0.000	-	0	6	15	21	0.286
詹筱筑 - 中港高中	女	0	5	5	0.000	-	0	4	15	19	0.211
于修婷 - 國立體大	女	0	5	5	0.000	-	0	4	15	19	0.211
劉聿兒 - 清華大學	女	0	4	4	0.000	-	0	3	12	15	0.200
鄭婕伶 - 國立體大	女	0	5	5	0.000	-	0	3	15	18	0.167
許依宸 - 北市大	女	0	5	5	0.000	-	0	2	15	17	0.118
黃湘玲 - 海山高中	女	0	5	5	0.000	-	0	2	15	17	0.118
簡詩耘 - 個人報名	女	0	3	3	0.000	-	0	1	9	10	0.100
姚力榳 - Dreams乒乓	女	0	5	5	0.000	-	0	0	15	15	0.000
蔡可萱 - 中港高中	女	0	5	5	0.000	-	0	0	15	15	0.000
