name	Gr	W	L	Tot	W_pct	selection	finals_app	g_W	g_L	Tot_Gms	g_W_pct
葉伊恬 - 合作金庫	女	6	0	6	1.000	第一次賽入選	1	18	3	21	0.857
吳映萱 - 國泰人壽	女	6	0	6	1.000	第一次賽入選	1	18	5	23	0.783
李昱諄 - 國泰人壽	女	7	1	8	0.875	第二次賽入選	1	23	7	30	0.767
彭郁涵 - 國泰人壽	女	6	1	7	0.857	第二次賽入選	1	19	9	28	0.679
黃禹喬 - 國泰人壽	女	10	2	12	0.833	第三次賽入選	2	33	13	46	0.717
陳忞昕 - 合作金庫	女	8	2	10	0.800	第三次賽入選	1	26	10	36	0.722
高凡媞 - 國泰人壽	女	12	3	15	0.800	第四次賽入選	2	38	25	63	0.603
黃 歆 - 國泰人壽	女	11	3	14	0.786	第四次賽入選	1	38	16	54	0.704
鄭先知 - 國泰人壽	女	12	4	16	0.750	-	2	43	20	63	0.683
簡彤娟 - 國泰人壽	女	10	4	14	0.714	-	0	36	19	55	0.655
劉馨尹 - 國泰人壽	女	10	4	14	0.714	-	1	35	23	58	0.603
蘇珮綾 - 合作金庫	女	10	4	14	0.714	-	0	33	22	55	0.600
蔡昀恩 - 合作金庫	女	9	4	13	0.692	-	0	32	16	48	0.667
陳琦媗 - 合作金庫	女	9	4	13	0.692	-	0	34	18	52	0.654
鄭樸璿 - 合作金庫	女	9	4	13	0.692	-	1	30	17	47	0.638
王意如 - 合作金庫	女	9	4	13	0.692	-	1	32	20	52	0.615
王媺淇 - 國泰人壽	女	9	4	13	0.692	-	0	29	19	48	0.604
貢慕慈 - 合作金庫	女	8	4	12	0.667	-	0	29	17	46	0.630
陳思羽 - 國泰人壽	女	4	2	6	0.667	-	1	14	9	23	0.609
吳宜琪 - 北市大	女	8	4	12	0.667	-	0	26	20	46	0.565
李婉瑄 - 北市大	女	8	4	12	0.667	-	0	26	21	47	0.553
陳慈瑄 - 高雄中學	女	8	4	12	0.667	-	0	26	22	48	0.542
王小昕 - 合作金庫	女	9	5	14	0.643	-	0	32	22	54	0.593
陳映蓁 - 國泰人壽	女	7	4	11	0.636	-	0	26	17	43	0.605
朱以晴 - 國泰人壽	女	7	4	11	0.636	-	0	25	18	43	0.581
張孟媫 - 臺灣體大	女	5	3	8	0.625	-	0	18	11	29	0.621
林芊瑩 - 國泰人壽	女	6	4	10	0.600	-	0	23	14	37	0.622
林珈芝 - 合作金庫	女	6	4	10	0.600	-	0	18	13	31	0.581
劉如紜 - 合作金庫	女	6	4	10	0.600	-	0	20	15	35	0.571
黃淨嘉 - 合作金庫	女	6	4	10	0.600	-	0	21	17	38	0.553
蔡佩蓉 - 合作金庫	女	6	4	10	0.600	-	0	19	18	37	0.514
廖庭瑤 - 國泰人壽	女	5	4	9	0.556	-	0	19	14	33	0.576
李唯寧 - 合作金庫	女	5	4	9	0.556	-	0	20	18	38	0.526
郭語瑄 - 合作金庫	女	5	4	9	0.556	-	0	20	18	38	0.526
陳亭婷 - 臺灣師大	女	6	5	11	0.545	-	0	22	17	39	0.564
黃君凡 - 合作金庫	女	6	5	11	0.545	-	0	23	21	44	0.523
張浿珊 - 國泰人壽	女	6	5	11	0.545	-	0	21	22	43	0.488
林佳慧 - 國泰人壽	女	4	4	8	0.500	-	0	19	14	33	0.576
梁羽芯 - 合作金庫	女	4	4	8	0.500	-	0	16	13	29	0.552
巫嘉恩 - 國泰人壽	女	4	4	8	0.500	-	0	16	14	30	0.533
葉珈妤 - 合作金庫	女	4	4	8	0.500	-	0	17	17	34	0.500
裴紫妮 - 臺灣師大	女	5	5	10	0.500	-	0	21	22	43	0.488
魏安屏 - 國泰人壽	女	4	4	8	0.500	-	0	16	18	34	0.471
鄭嘉倩 - 國泰人壽	女	5	5	10	0.500	-	0	18	22	40	0.450
陳祈韻 - 合作金庫	女	4	5	9	0.444	-	0	20	20	40	0.500
陳皓萱 - 內湖高工	女	4	5	9	0.444	-	0	16	22	38	0.421
蔡豐恩 - 國泰人壽	女	3	4	7	0.429	-	0	13	12	25	0.520
洪苡茿 - 合作金庫	女	3	4	7	0.429	-	0	14	13	27	0.519
李霈蓉 - 國泰人壽	女	3	4	7	0.429	-	0	15	14	29	0.517
林芯妤 - 國泰人壽	女	3	4	7	0.429	-	0	12	14	26	0.462
陳佳宜 - 國泰人壽	女	3	4	7	0.429	-	0	12	16	28	0.429
梁羽宸 - 北市大	女	3	4	7	0.429	-	0	11	16	27	0.407
陳沁伶 - 八馬國際	女	2	4	6	0.333	-	0	10	12	22	0.455
林琬容 - 國泰人壽	女	2	4	6	0.333	-	0	11	15	26	0.423
呂函叡 - 合作金庫	女	2	4	6	0.333	-	0	11	15	26	0.423
呂瑀恩 - 合作金庫	女	2	4	6	0.333	-	0	9	13	22	0.409
蔡佳靜 - 合作金庫	女	2	4	6	0.333	-	0	10	15	25	0.400
黃文婷 - 臺灣體大	女	2	4	6	0.333	-	0	9	15	24	0.375
賴郁蓁 - 合作金庫	女	2	4	6	0.333	-	0	8	14	22	0.364
楊芸婕 - 國泰人壽	女	2	4	6	0.333	-	0	8	15	23	0.348
呂姍穎 - 八馬國際	女	2	4	6	0.333	-	0	8	15	23	0.348
鄭晴文 - 國泰人壽	女	2	4	6	0.333	-	0	7	14	21	0.333
黃韞纈 - 合作金庫	女	2	4	6	0.333	-	0	6	13	19	0.316
林翌蓁 - 高雄中學	女	2	5	7	0.286	-	0	12	16	28	0.429
林奐諪 - 合作金庫	女	2	5	7	0.286	-	0	11	18	29	0.379
賴萱恩 - 國泰人壽	女	2	5	7	0.286	-	0	10	17	27	0.370
簡宏卿 - 內湖高工	女	2	5	7	0.286	-	0	11	19	30	0.367
葉馨榆 - 國泰人壽	女	2	5	7	0.286	-	0	8	18	26	0.308
梁菀庭 - 國立體大	女	2	5	7	0.286	-	0	8	18	26	0.308
廖頤暄 - 國泰人壽	女	2	5	7	0.286	-	0	7	17	24	0.292
姜沛昀 - 福誠高中	女	1	4	5	0.200	-	0	7	12	19	0.368
陳芋臻 - 合作金庫	女	1	4	5	0.200	-	0	7	13	20	0.350
劉羽英 - 八馬國際	女	1	4	5	0.200	-	0	6	14	20	0.300
林姿妍 - 臺南桌委	女	1	4	5	0.200	-	0	5	14	19	0.263
陳瑞翎 - 國泰人壽	女	1	4	5	0.200	-	0	5	14	19	0.263
謝于璇 - 臺灣師大	女	1	4	5	0.200	-	0	4	14	18	0.222
張滋育 - 海山高中	女	1	4	5	0.200	-	0	3	14	17	0.176
黃敏瑜 - 北市大	女	1	5	6	0.167	-	0	11	16	27	0.407
黃薇安 - 合作金庫	女	1	5	6	0.167	-	0	8	17	25	0.320
洪可珊 - 北市大	女	1	5	6	0.167	-	0	4	15	19	0.211
林芯彤 - 國泰人壽	女	0	4	4	0.000	-	0	7	12	19	0.368
許淳瑄 - 國泰人壽	女	0	4	4	0.000	-	0	5	12	17	0.294
謝昕融 - 合作金庫	女	0	4	4	0.000	-	0	5	12	17	0.294
蔡侑臻 - 合作金庫	女	0	5	5	0.000	-	0	6	15	21	0.286
詹筱筑 - 中港高中	女	0	4	4	0.000	-	0	4	12	16	0.250
劉聿兒 - 清華大學	女	0	3	3	0.000	-	0	3	9	12	0.250
王毓潔 - 國泰人壽	女	0	4	4	0.000	-	0	4	12	16	0.250
于修婷 - 國立體大	女	0	5	5	0.000	-	0	4	15	19	0.211
吳妤彤 - 智淵乒乓	女	0	4	4	0.000	-	0	3	12	15	0.200
鄭婕伶 - 國立體大	女	0	5	5	0.000	-	0	3	15	18	0.167
許依宸 - 北市大	女	0	4	4	0.000	-	0	2	12	14	0.143
李任悅 - 國泰人壽	女	0	4	4	0.000	-	0	2	12	14	0.143
黃湘玲 - 海山高中	女	0	4	4	0.000	-	0	2	12	14	0.143
簡詩耘 - 個人報名	女	0	3	3	0.000	-	0	1	9	10	0.100
姚力榳 - Dreams乒乓	女	0	5	5	0.000	-	0	0	15	15	0.000
蔡可萱 - 中港高中	女	0	5	5	0.000	-	0	0	15	15	0.000
