name	Gr	g_W	g_L	games	g_W_pct	W	L	matches	W_pct	selection
蘇昱綸 - 合作金庫	男	18	4	22	0.818	6	0	6	1.0	第1次賽入選
洪敬愷 - 第一銀行	男	18	7	25	0.72	6	0	6	1.0	第1次賽入選
黎彥君 - 第一銀行	男	28	10	38	0.737	9	1	10	0.9	第2次賽入選
張佑安 - 第一銀行	男	20	8	28	0.714	6	1	7	0.857	第2次賽入選
林彥均 - 第一銀行	男	37	13	50	0.74	11	2	13	0.846	第3次賽入選
馮翊新 - 合作金庫	男	48	16	64	0.75	15	3	18	0.833	
黃彥誠 - 合作金庫	男	30	14	44	0.682	9	2	11	0.818	第3次賽入選
葉致緯 - 第一銀行	男	39	11	50	0.78	12	3	15	0.8	
曾子彧 - 合作金庫	男	37	14	51	0.725	11	3	14	0.786	
廖振珽 - 第一銀行	男	35	13	48	0.729	10	3	13	0.769	
陳建安 - 合作金庫	男	31	11	42	0.738	9	3	12	0.75	
徐絃家 - 合作金庫	男	29	17	46	0.63	9	3	12	0.75	
陳凱程 - 合作金庫	男	39	26	65	0.6	12	4	16	0.75	
孫嘉宏 - 合作金庫	男	28	20	48	0.583	9	3	12	0.75	
蔡天羽 - 合作金庫	男	27	15	42	0.643	8	3	11	0.727	
彭王維 - 乒乓彭	男	34	19	53	0.642	10	4	14	0.714	
黎昕祐 - 第一銀行	男	35	21	56	0.625	10	4	14	0.714	
黎昕陽 - 第一銀行	男	26	11	37	0.703	7	3	10	0.7	
楊振岳 - 合作金庫	男	23	18	41	0.561	7	3	10	0.7	
楊子儀 - 合作金庫	男	31	19	50	0.62	9	4	13	0.692	
楊恆韋 - 第一銀行	男	27	15	42	0.643	8	4	12	0.667	
王泰崴 - 合作金庫	男	28	18	46	0.609	8	4	12	0.667	
李佳陞 - 第一銀行	男	28	21	49	0.571	8	4	12	0.667	
黃培祐 - 合作金庫	男	27	22	49	0.551	8	4	12	0.667	
楊嘉安 - 第一銀行	男	28	23	51	0.549	8	4	12	0.667	
楊皓任 - 第一銀行	男	33	20	53	0.623	9	5	14	0.643	
梁振威 - 合作金庫	男	23	16	39	0.59	7	4	11	0.636	
何恩 - 松山家商	男	24	17	41	0.585	7	4	11	0.636	
施佳宏 - 第一銀行	男	24	18	42	0.571	7	4	11	0.636	
張秉丞 - 第一銀行	男	25	19	44	0.568	7	4	11	0.636	
戴博鈞 - 合作金庫	男	24	20	44	0.545	7	4	11	0.636	
蔡榜原 - 合作金庫	男	23	22	45	0.511	7	4	11	0.636	
蔡淳佑 - 臺南桌委	男	18	14	32	0.562	5	3	8	0.625	
譚吉倉 - 臺南桌委	男	16	15	31	0.516	5	3	8	0.625	
吳元佑 - 合作金庫	男	23	13	36	0.639	6	4	10	0.6	
葉伊恩 - 智淵乒乓	男	22	14	36	0.611	6	4	10	0.6	
程弘宇 - 松山家商	男	22	16	38	0.579	6	4	10	0.6	
林鄭文哲 - 合作金庫	男	20	15	35	0.571	6	4	10	0.6	
王晨又 - 第一銀行	男	20	17	37	0.541	6	4	10	0.6	
蘇晨翔 - 合作金庫	男	21	18	39	0.538	6	4	10	0.6	
曾暐勛 - 臺南桌委	男	18	16	34	0.529	6	4	10	0.6	
洪哲硯 - 合作金庫	男	21	15	36	0.583	5	4	9	0.556	
彭靖宥 - 合作金庫	男	20	16	36	0.556	5	4	9	0.556	
李承恩 - 臺灣體大	男	18	15	33	0.545	5	4	9	0.556	
鄭旻修 - 合作金庫	男	21	18	39	0.538	5	4	9	0.556	
王冠程 - 八馬國際	男	21	19	40	0.525	5	4	9	0.556	
郭家宏 - 臺灣師大	男	18	18	36	0.5	5	4	9	0.556	
闕壯庭 - 北市大	男	17	17	34	0.5	5	4	9	0.556	
黃浩瑋 - 臺灣體大	男	15	14	29	0.517	4	4	8	0.5	
蔡賾安 - 第一銀行	男	15	14	29	0.517	4	4	8	0.5	
林晉霆 - 第一銀行	男	18	17	35	0.514	4	4	8	0.5	
楊致興 - 北市大	男	13	13	26	0.5	4	4	8	0.5	
彭靖恩 - 臺南桌委	男	16	16	32	0.5	4	4	8	0.5	
賴竑亦 - 八馬國際	男	15	16	31	0.484	4	4	8	0.5	
梅日燁 - 臺灣師大	男	14	15	29	0.483	4	4	8	0.5	
梁庭瑋 - 國立體大	男	14	15	29	0.483	4	4	8	0.5	
蕭子睿 - 合作金庫	男	21	24	45	0.467	5	5	10	0.5	
黃弘州 - 屏東科大	男	14	18	32	0.438	4	4	8	0.5	
陳奕騰 - 第一銀行	男	20	17	37	0.541	4	5	9	0.444	
趙柏宥 - 合作金庫	男	18	17	35	0.514	4	5	9	0.444	
陳宜樂 - 第一銀行	男	16	19	35	0.457	4	5	9	0.444	
莊家權 - 合作金庫	男	16	14	30	0.533	3	4	7	0.429	
林子恩 - 臺灣體大	男	13	12	25	0.52	3	4	7	0.429	
張先騅 - 福誠高中	男	14	14	28	0.5	3	4	7	0.429	
高偉誌 - 智淵乒乓	男	11	12	23	0.478	3	4	7	0.429	
周秉澄 - 松山家商	男	12	14	26	0.462	3	4	7	0.429	
莊忠諺 - 合作金庫	男	12	14	26	0.462	3	4	7	0.429	
余奕慶 - 合作金庫	男	13	16	29	0.448	3	4	7	0.429	
戴茗葦 - 北市大	男	12	15	27	0.444	3	4	7	0.429	
辜崇晏 - 臺灣體大	男	12	15	27	0.444	3	4	7	0.429	
邱笠宸 - 合作金庫	男	11	14	25	0.44	3	4	7	0.429	
彭 旨 - 北市大	男	9	16	25	0.36	3	4	7	0.429	
張家皓 - 國立體大	男	17	15	32	0.531	3	5	8	0.375	
陳俊侑 - 東泰高中	男	12	15	27	0.444	3	5	8	0.375	
黃毓仁 - 第一銀行	男	11	13	24	0.458	2	4	6	0.333	
董少丞 - 臺灣師大	男	10	13	23	0.435	2	4	6	0.333	
林孟帆 - 中華國中	男	10	14	24	0.417	2	4	6	0.333	
方詠恩 - 第一銀行	男	10	14	24	0.417	2	4	6	0.333	
陳俊廷 - 個人報名	男	9	13	22	0.409	2	4	6	0.333	
林一帆 - 智淵乒乓	男	9	13	22	0.409	2	4	6	0.333	
林大棋 - 福誠高中	男	9	14	23	0.391	2	4	6	0.333	
劉士銘 - 第一銀行	男	8	13	21	0.381	2	4	6	0.333	
楊謝翊 - 智淵乒乓	男	8	16	24	0.333	2	4	6	0.333	
周奕安 - 海山高中	男	8	16	24	0.333	2	4	6	0.333	
何少汯 - 香山高中	男	8	16	24	0.333	2	4	6	0.333	
張睿煬 - 第一銀行	男	10	17	27	0.37	2	5	7	0.286	
曾宥維 - 八馬國際	男	9	16	25	0.36	2	5	7	0.286	
吳秋信 - 臺灣體大	男	9	16	25	0.36	2	5	7	0.286	
姜承佑 - 海山高中	男	9	16	25	0.36	2	5	7	0.286	
余秉宸 - 合作金庫	男	9	12	21	0.429	1	4	5	0.2	
柯勇全 - 智淵乒乓	男	9	12	21	0.429	1	4	5	0.2	
方炳崴 - 第一銀行	男	8	12	20	0.4	1	4	5	0.2	
陳柏諺 - 海山高中	男	7	12	19	0.368	1	4	5	0.2	
彭聖棋 - 香山高中	男	7	12	19	0.368	1	4	5	0.2	
黃守心 - 松山家商	男	7	14	21	0.333	1	4	5	0.2	
張力元 - 八馬國際	男	5	12	17	0.294	1	4	5	0.2	
邱祐宏 - 臺灣師大	男	5	12	17	0.294	1	4	5	0.2	
蕭惟之 - 八馬國際	男	5	13	18	0.278	1	4	5	0.2	
張岳 - 彰德國中	男	5	13	18	0.278	1	4	5	0.2	
葉易樺 - 八馬國際	男	4	13	17	0.235	1	4	5	0.2	
陳又安 - 至正國中	男	3	12	15	0.2	1	4	5	0.2	
謝譯賢 - 個人報名	男	3	14	17	0.176	1	4	5	0.2	
呂亮緯 - 金石乒乓	男	11	16	27	0.407	1	5	6	0.167	
黃祐柏 - 合作金庫	男	7	16	23	0.304	1	5	6	0.167	
李俊霆 - 第一銀行	男	5	15	20	0.25	1	5	6	0.167	
洪翔宥 - 海山高中	男	5	16	21	0.238	1	5	6	0.167	
廖堉棋 - 合作金庫	男	3	6	9	0.333	0	2	2	0.0	
吳喆安 - 高雄師範	男	7	15	22	0.318	0	5	5	0.0	
張秉恩 - 第一銀行	男	5	12	17	0.294	0	4	4	0.0	
許宸逢 - 八馬國際	男	4	12	16	0.25	0	4	4	0.0	
林學庸 - 臺南桌委	男	4	15	19	0.211	0	5	5	0.0	
林子鈞 - 個人報名	男	3	12	15	0.2	0	4	4	0.0	
謝承翰 - 東山高中	男	3	15	18	0.167	0	5	5	0.0	
李宇 - 東山高中	男	3	15	18	0.167	0	5	5	0.0	
黃紹愷 - 中信國小	男	2	12	14	0.143	0	4	4	0.0	
張致榮 - 藝術高中	男	2	15	17	0.118	0	5	5	0.0	
許詠傑 - 藝術高中	男	2	15	17	0.118	0	5	5	0.0	
陳浩洋 - 東山高中	男	2	15	17	0.118	0	5	5	0.0	
蔡宗桓 - 金石乒乓	男	1	12	13	0.077	0	4	4	0.0	
陳楷庭 - 屏東科大	男	1	15	16	0.062	0	5	5	0.0	
陳柏鈞 - 金石乒乓	男	0	15	15	0.0	0	5	5	0.0	
朱芫毅 - 至正國中	男	0	15	15	0.0	0	5	5	0.0	
虞善琦 - 	男	0	15	15	0.0	0	5	5	0.0	
顏瑜廷 - 個人報名	男	0	15	15	0.0	0	5	5	0.0	
楊博翔 - 臺灣師大	男	0	3	3	0.0	0	1	1	0.0	
林思佑 - 東山高中	男	0	15	15	0.0	0	5	5	0.0	
李冠炫 - 香山高中	男	0	15	15	0.0	0	5	5	0.0	
